[Nivel1]
fuente = terrenogen.png
mapa =$$$$$$$$$$$$$$$$$$$$$$$$$$$$$$$$$$$
      $........$$$$$$$$$$$$$$$$$........$
      $.................................$
      $.$$$$$.....................$$$$$.$
      $.$$$$$..$$$$$$$$$$$$$$$$$..$$$$$.$
      $.................................$
      $$.$$$$$$$.$$$$$$.$$$$$$.$$$$$$$.$$
      $$.$$$$$$$.$$$$$$.$$$$$$.$$$$$$$.$$
      $$...............................$$
      $$.$$$$$$$...............$$$$$$$.$$
      $$.$$$$$$$.$$$$$$$$$$$$$.$$$$$$$.$$
      $$.$$$$$$$.$$$$$$$$$$$$$.$$$$$$$.$$
      $$...............................$$
      $$.$$$$$$$$$$$$$$$$$$$$$$$$$$$$$.$$
      $$.$$$$$$$$$$$$$$$$$$$$$$$$$$$$$.$$
      $$.$$$.......................$$$.$$
      $..$$$.$$$$$$$$$$$$$$$$$$$$$.$$$..$
      $......$$$$$$$$$$$$$$$$$$$$$......$
      $$$$$$$$$$$$$$$$$$$$$$$$$$$$$$$$$$$

[.]
tipo = cesped
x = 27
y = 5
col = 0

[$]
tipo = roca
x = 8
y = 6
col = 1
